#####################################################################  
||o. .....................................................  ...... o|| 
||.. %%%%%%%%%%%%%%%%        ...     %%%%%%%%%%%%%%  |%|..   %%%%   || 
||..        |%|   |%|     |%|...     |%|        |%|  |%|..    |%|   || 
||..        |%|   |%|     |%|...     |%|        |%|  |%|..    |%|   || 
||..        %%%%%%%%  .   |%|...     %%%%%%%%%%%%%%     ..   %%%%.  || 
||..        |%|       .   |%|...    ............... |%| ..       .  || 
||..        %%%%%%%%%%.   |%|...    %%%%%%%%%%%%    |%| ..   %%%%.  || 
||..               |%|.             |%|......       |%| ..    |%|.  || 
||..     ......... |%|.             |%|......|%|        ..    |%|.  || 
||..|%|  |%|%%%|%|.|%|. |%|            ......|%|        ..|%| |%|.  || 
||..|%|  |%|   |%|..     %%%%%%%%%%%%  ......|%|         .|%|.      || 
||..|%|  |%|   |%|..           ...|%|     %%%%%%        . |%|.      || 
||..|%|            .           ...|%|               |%| ..|%|.      || 
||..|%|  %%%%%%%%%%%%%         ...|%|%%%%%%%%%%     |%| ..|%|%%%%%  || 
||...............................................   |%| ..........  || 
||   ............................................          .......  || 
||..|%|  |%|   |%|..    %%%%%%%%%%%%%  ......|%|    |%| ..|%|.      || 
||..|%|  |%|   |%|..           ...|%|     %%%%%%    |%| ..|%|.      || 
||..|%|            .           ...|%|               |%| ..|%|.      || 
||..|%|  %%%%%%%%%%%%%         ...|%|%%%%%%%%%%     |%| ..|%|%%%%%  || 
||...............................................   |%| ..........  || 
||  .............................................          ....... o|| 
 ##################################################################### 